NO textures/greystone.png
SO textures/greystone.png
WE textures/greystone.png
EA textures/greystone.png

F 220,100,0
C 200,50,0

11111
10001
10N01
10001
11111