NO ./textures/mossy.png
SO ./textures/mossy.png
WE ./textures/mossy.png
EA ./textures/mossy.png
F 128,0,128
C 200,200,200

1111111111111111111111111111111
1000000001000000000001000000001
1011111101011111111101011111101
1000000101000000000101000000101
1111100101111110111101010111101
1000100000000010000001010100001
1010111111111011111111010111111
1010000000001010000010000100001
1011111111101011111011111101101
1000000000101000000010000000101
1111111110101111111011111111101
1000000010100000001000000000101
1011111010111111111111111011101
1010000010000000000000010010001
1010111111111111111111011110111
100000000000000000000000000N001
1111111111111111111111111111111