NO ./textures/bluestone.png
SO ./textures/greystone.png
WE ./textures/redbrick.png
EA ./textures/eagle.png

F 50,50,50
C 100,100,100

1111111111111111111111111111111111111111111111111111111111111111111111
1000000000000000000000000000000000000000000000000000000000000000000001
1000111111110001111110000001111100001111110001111111111111110001111001
1000100000010001000010000001000000001000010001000000000000010001000001
1000100000010001000010000001000000001000010001000000000000010001000001
1000111111110001111110000001111100001111110001111111111111110001111111
1000000000000000000000000000000000000000000000000000000000000000000001
1111011111110111111011111111111101111111011111110111111111110111111001
1000010000010000000010000000000001000000010000010000000000010000000001
1000010000010000000010000000000001000000010000010000000000010000000001
1111011111110111111011111111111101111111011111110111111111110111111111
1000000000000000000000000000000000000000000000000000000000000000000001
1001111111110111111011111111111101111111011111110111111111110111111001
1001000000010000000010000000000001000000010000010000000000010000000001
1001000000010000000010000000000001000000010000010000000000010000000001
1001111111110111111011111111111101111111011111110111111111110111111111
10000000000000000000000000000000000000000000000000000000000000000000W1
1111111111111111111111111111111111111111111111111111111111111111111111